1111111111111111111111111
1E00G0000001C00000C000001
10101001G000010100101CC01
1010110101110000001011101
1P0000C0GC0101110000000C1
1G001001000001000GC01C001
11000011000G0000100000011
1111111111111111111111111
