1111111111111111111111111
1E0000000001C00000C000001
101010010000010100101CC01
1010110101110000001011101
1P0000C00C0101110000000C1
100010010000010000C01C001
1100001100000000100000011
1111111111111111111111111
