111111111
1001000C1
100001101
1011E011111
100000001
1P0000001
100000001
100000001
111111111