1111111111111
10010000000C1
1GP0011111001

1P0011E0000G1
1111111111111