11111111111111
1P00000100C001
11110101111101
1C000100000001
10111110111111
101000001000G1
101011111011C1
10100000000101
11110111110111
1C0000010C00E1
11111111111111