111111111
1001000C1
1G0001101
1P0011E01
100000001
100000001
100000001
100000001
111111111