11111111111111
1P000001000001
11110101111101
10000100000001
10111110111111
10100000100001
10101111101101
10100000000101
11110111110111
1C0000010000E1
11111111111111